NO ./img/damask.xpm
SO ./img/golden-pattern.xpm
WE ./img/pngtree.xpm
EA ./img/seamless.xpm

F 147, 120, 120
C 80, 210, 225


         1111111111111111111111111   1
        1000000000110000000000001  11
        10110000011100000000000011
        1001001000000000000000001
111111111011001001110000000000001
100000000011000001110100011111111
11110111111111011100000010001
1111111111111111111111111111
1111111111111111111111111111
1110111111111011101010010001
1100000010101011100000010001
100000010S0000001100000010001
100000000000000001101010010001
1100000111010101111101111000111
11110111 1110101 101111010001 
11111111 1111111 11111111111
