NO ./img/leather_aqua.xpm
SO ./img/leather_brown.xpm
WE ./img/woood.xpm
EA ./img/woood.xpm

F 166, 187,10
C 185, 243, 252


11111   1111111 1111111111111
10000111000000010000000011
1000011000000001000000001
1000000000000000000000001
100000000000N0000000011111
1000000011111100000000001
1000010000001000000000001
11111 111111 11111111111111